2222222222222
2000101110002
2021212121202
2010000101102
2120212121212
2010001111102
2121212121212
2011011000102
2121212120212
2011111000102
2021212121202
2000101010002
2222222222222
